dtl: xzs
clb: zgk fzx lrq hqn jhq
xhb: mhm vrn
kqv: rbp kgf lvj
tcv: ftv hhn
vhr: tld xnx vhn nmn kqd
gsz: bjp kfj fzc
pkr: rvk
hmg: gvv dzq gtk
gdq: jlk xvm hgl
ftn: qsl mpq
mqg: tst qqq
szb: fsx xrp ssj tnf tsx
skq: khr zdh lkl jxz
kmq: mcb mtq kmm bnv
jqz: cdb
hph: xsm tmv
xkb: vqx kbq
krd: pxk bgh zmj
bld: fcd rkp
htp: hcc bbd
str: ppn mqn
svv: jxt
nzs: dzs mrd
nzv: dhp
zgf: kkq
sqc: tlb bvs crq vhh
fgq: dhs zbp qqt bbb gkn
xnr: dnk
zch: xdh
hnr: jnc gqc
msn: rgv drs grc cxz
fcs: bqv
jtg: ldj tbk ktd txk
hqv: mfb rzh
xhd: rnd
jsp: jjs xjz fsn zgr
rcn: fmh jmj gqg
knt: zxr kxt fgh
cvr: rjg rvx qtp
fsx: lkx bxb vht pxz rzm kcv
vnh: qbv hhn bph
tsg: npc svv nsx fgs
xzx: hnr qkx xvj tln
mbt: tmx njf jxz rsc
kcv: hnd
pgf: dnx qck dhc mpq
pdd: jmj khd cfk
pbg: mmm hgr bcr vgp
ghq: rzf grc ddh psl
dds: mhq jcr dtb rpk pxv
ljc: djf plm fxz hbs
nlc: rxb tzc
trg: pbx nct rvb
bpk: qzx fhp trg tst
ldn: zhq tzc
xdn: mdx
gzj: jdb lzp lvq
lbl: kts dzs tvs
rfd: dlv sct qcl djk
qgb: zmc xrx fqn xxf
fvp: xdn tld qpg brb
bpn: vhh
npz: tvl hfd
glb: gdq xxk skt qqq
rpb: fdc
rbq: dzd xkn hgt
zcr: llh rcz kdc xfj vhx xrv
mrj: lkc
nbp: dxt jdn
hrv: fqx msn
hzc: lzk
xxp: cdd zmj jpz qrp
ggq: hzj jnc hts zzb
pxk: bdp vvn mmr
bdc: jgq
pqh: vqd qdj ctf
lvq: xdh qrp rbc hst dcl
dth: kqf dhs mkx
xkk: tbq pvb lcb thz
gdc: xvg xnz rxb vvh
mdj: tkc npb cvl rpn
lfs: kbv
bfb: hqj
lnr: rsc dtv
sfz: fkp bxh bkz nlc
mrr: nkq htq zgq nmp
mkn: vqn szz mtx
fdq: dhz
hkb: vbr qmq hqv
qkf: hbv rmc tzt
lll: kph lfs
ktd: fqf jfz
jjh: nmv mkk ndd
jdn: gtz
zpl: tgg mfk xxf bnm fds
vxx: vvb
msc: nxz gcq bnm qtp xdz
kmd: rhd
vzd: cnm
pmx: ftk lsb mzc
qdt: rmd cpx
bqx: qjq rcn hrs tkd
tqp: lsg
bkc: zph
qsf: hfj ktr brb
bcr: jzj
ggm: sfq kbs
zvq: hjf vrn kbk bkd
nmq: jsc jpt mqc knt
zjb: lll qmg zcx zbd
brn: nzg
mcr: kph cvl znp
ddq: bkz xxl chl
ppn: rzf mvz
kgm: bqk dkt nsq
jxg: mtj
jgv: mnj
tmb: hlf kxt rgj
fjc: lcf mss
pbf: zgt fbr rmb frj pzc cpt fgs
krg: ztn xtt ghv nvm
nxd: rgv rmj clf ppn qls
lsh: brx brn hvv lmg zbd
xlz: mhq rtx
xpn: hxr rfz zcf
bsp: vxx qls
cxj: cmr vjz nlc hhd
csb: fqx fnv qpg
bxt: jdn dhz mvt
zbp: rhb qrq
zxb: rql njb vlk sgj nlf
dbl: lvh cfd xnr jvc zbn
xtq: prb bch trp qkx
qck: jdb
vqn: bbb
dtv: xdq
mmr: zhb flz
xff: qmg zgq
tsn: vhh ffm
ctn: mcj
qrh: zgq
bnt: tcv tbq bbq dnq
qht: nmh lkl
bkv: bxt pgr bzq lbg kmz
lcf: jqm
bbc: hlv rxs rbp jsb
svr: lch sxz htp hvr
ptb: rrr
hzk: bdc
nmh: mvb
lcr: lvp
kbf: dcq ngv tsx
bxc: rcb cvk gnv xhz
mcf: dhz gsz ddh
btk: xfs lks tlx sfm hbs
sbt: xfj tjs qqz ggc
fbm: tgg szl
kls: xjz zkh jgp jpk
djf: jpz
qzn: mzc vvq zgk hjp
stp: grg
tpp: fqt ncp
kmv: fhc gkj brd
pbx: lgn mlc
gsr: xgz xvg
lrs: tjs fjs fzx
drx: zfb
llj: lfh mtf hfj lrs
skj: ttj mjt knh
nrv: cqt hmf
fnv: npv
hxr: fgs
vgp: mmz
vgm: xcr zcs
qkk: sjm nlf jpv
zll: vbg pgt khn zxj
xfb: rtx chf gzj
bvs: ctv hsr dlr qdg
qmv: tmr htl zgf rvn njk
bnc: kfj rmm
fqf: hlp ktl ctv
zcg: nvz
rkx: ksc ftv
xhz: zxl msh tln
qmq: vvq
gkm: bmg skg pkr
jcr: brn bdg mlc
bxb: xzs
rcz: hhd jqq plt
mtq: jpk nvz
ctx: ssl czn ctn bdg xzt
bng: mdx tmb hxj kvb
ngx: rtz gqc rtc
snd: bcz cdb
krs: kmz
mfs: tlv rsc
qtn: qqq vrg
bjd: rrr vxj
jzf: zdh hzc ztn
gqc: kgf
ppm: fsz gkn mkx mcq
mdh: jgp lkc
rsb: fkt kxt
brr: kqd rmd qxz lkm jxg xmn
jzz: bcr mcq vvt fcs
pbj: djp
ngz: xfj vhr dxq skj
kzc: knv fdg xbj nfb
njt: xbx tzt mzh mlc
nmk: vgm zdb hxj jgs
ssj: bcz vkl
mpq: rhd
mhb: qck xfs hrl
dkt: smb dmj pdc
rgc: kdl qrq
rcc: stz llr bpn cdc
bst: xvg xhb gqp fmh
brx: qms
bvr: qkv hbl lmh vks
dsj: zxr jqq fms
plm: qcd kbq
hxc: cbr mll nlf
rxt: flz tmq
fqp: tsc qrc mpd hlf qdt
fxz: vcg
jcx: lqp pqg tbd
txr: dlv frb zcx vzg
cqt: rzf
qmk: rld xrm
dst: mqn zmn zxr zkh
djm: fzj gsz hqf nlk kfk
srj: mzc rmd
xsk: jmj tpn
mjt: gmg ftv
lhc: dlc tsk xnz
dhj: pzc vqd
vfx: hmg zcz xmm npb
zkm: rtq bcz vtk fgs
znp: bqv
hft: bsp gtz
kbg: pvn psp lbp bjd
hhg: bfq xhn
hlf: cqt mdt
qrc: cnh ktj mvz hhn
qqz: tgv dzl ksc
pxz: zgq
jjg: mnj bnf pxz
hbs: ppr
bgh: jqm qqq
sgr: tbk dmv qdg gsz
prf: tst mtm
dlp: nrv vvh mqn mzc
kkq: vkb rsp tdq fkt jbv
vss: lfs
zjl: rtx
srk: zpp rgq msr
rqm: tsn prp cpx knh
bbd: tlv
fkz: mtj vhx
dvf: lrq gtx
ngj: vtj npb
ppv: krs
thf: dcm vzd qsl vch
vtq: nmv dqk fcz qqt pjt
rcb: scm
dbd: tlz
lnk: gtf
fxh: skj trt nqc kmv sxl jkn bbg
nct: gnb pgh vxg
gqk: qkk jbv
slx: slb pbj kzq vvb
rqt: ndh vbb grg
lzp: qcd
xln: hfd zvb
nfd: tzn rtc
kgq: dgb ckd dvt gvp
dxq: rvx zks jjs
kbq: cpt kgf lkx
lvf: vvt npz
lzq: vzf vkb hzk
jjj: nfl nkk ftj
rgj: rsb fcg jjs
xlg: fhl ntf hqf
phk: grc xrm qmq vck
gvv: prb prf fhp
dzl: lmp
nrf: zhq fcd lmf zhv
sbc: tgg qqv rgt
ttj: srj
mjq: bpn fqn jgq zjv vzk
tpn: hhm lbg kmm
qnq: pvg nrl pnh rqh
tmk: dbv bdp mnj jrg
sgj: ncf
txj: jhq tmv qls sxl
gqh: qdg rqt lxb bqk
hrl: mtx
jqn: lbp vxf vjz sbf crn
sdr: rgc gcp hvv
jkt: qdt pdd khd nfq
cpx: hlp
vjr: rlb qcs pmm crk
npv: cbr
zdl: rhl rpb qrp qhr
dzc: lcb gqp zhq
bnv: jkg mdx
ktr: gsr stp qcs
trm: pvg vtk fbr
nql: ngt
lks: lkx vrd
dxt: lqv
nsq: czh hhq
vht: tln
jpz: tqq qmg scm
scc: bdc ktt mll
zcj: ggk dxq qkc hjb
rql: dzl bgb qjx
hgs: lbp nmg vlk sxl
cqp: fqf sfz
nvf: fzj
rhs: pvg brx tpp tmq mtx rfz
znc: vss nrl mbz qkj
mzm: gvx nkq ncp fdc xff
dxv: hjg zks cmh
skv: xsn
nbs: ppm tvl cxd
kgf: dcl
fkr: vbg zsq xpr lnl
kfr: vrg dbd
zbd: xln
rzh: llh skp hzv mtf
tmx: vxb
lmh: ngv qrh hnd rgq
lvh: bvr qtn ngx
vzk: mvz
pcf: vmk vtk bfq gtk
cvv: mcb xdz ctv
cbl: kjd hkf kmc vmq
cvk: kph tqq
tbf: jvx svp kbq htd ssj vmx
gmf: kzj pzr vnl qmg
rtm: ckd ctf jjh
xxf: knv nlk tct
qcl: rzd mqv
rfc: jsm xln rzm ngj zbc
rmc: ncp
mnn: tbc jmj
vkd: tvs fzh vks czn
xvm: fsh
kmj: zch vmx
stz: nhv zgf fdx cnf ffm rfp qqv
pcq: jxd ngd bzq vzk vhx zgr nvz
bmg: rng dkn rzd
tbc: nmn
ftk: kmz
zks: hzk lxh
gqb: fdr jlj
hxz: pjk sqp
mjm: zzd bbq xdd drs
tzq: ljj nrd lfc jkm tgh
jkp: vqp mcq hnd vbg
nmg: tsk
ssr: ddq hsr nfb nfl krj
jpv: srp mrj
brb: stc zgk dlc zcg gcc
rrr: dxt pvb nlk
bph: ddh lmp
ngt: vbb jpt
xtt: fcl ssl lvq
bvz: nfd lnr nvf fsz lcr
gvf: pth gcq mjb lvz
hbd: nqm dnb mzf
vzg: vzr kfr
rfm: mtt qtn rcb rmb
sfm: gkn xtl qrq
tgj: dpv
dqk: bqs vgp
xzd: rmm nql xjt qtr
jth: pqg
rxr: cdd
rsx: xlh jfp tvh
pjt: xhn ntz
hzj: qzx kbf lkx kbs vtk
prp: mjb
rgg: fqg kmz rbq tcd vnh
lkn: mqq lll tgj
ndb: zch qgq dbd
nnm: vmq bbc jvx zcz
mjk: slb vck bxf mtq
grp: fls rmb
bxh: cfk
vph: hjg hxj krs
ljj: snd tsp
vgj: xsn rfg hst
pzg: qhr zbn dtk nhp qqt mpl
jks: lhp qsg ppv mtz tlb
hgt: grc
ctv: msn
lzc: ntm
cbr: szl
tld: cxz
mfk: nmg
dlv: lcv
vxj: jgg nbp
xfm: xhd hfp
vmx: cdd jxt
smb: ktl dcs
cmb: zcx npb kst
cls: vmq tfh dtz rpk
ghv: ztn lvq
dbr: zdc pdc pph qfz fds
dcq: tzn mkn lch
hzv: njk clb
tfh: gnb vgp dgd
jxb: vvt cnt zdx zcz
sqf: dtz jvn qrh lmg
qlq: zvb dbd pgh tst
ppd: hph nqm msl vxj
jvf: mvb xkb dhb rmc ghv pqh
svp: qlh kzd mfv prk
fgs: xbx
gqq: xdd mdt chl
zzl: hkl jsc llr lfh
hkh: mhm plt jqq pth
rbs: hxr scm gfn
jcz: bkc fsn gqh
sqs: jnc
vxs: rtq bgk ftz qcg
vkb: qgm bbg
fvz: nqt pgh fsh
xgz: vbr xsm
jvr: vzr gtk lzp rxs mcq
dll: pqz skf xtv sbc
lqm: jdb xrr qdj stj
xjt: jkn
qkh: hxb xfn jrx sxz gxd
rxz: lbl lqb hhg
hbk: cjz zhb mbx tkn
htl: kbc sdg str
cfd: zfb
kmr: xjb pqp nvq tlz
bhl: dbd ljx nbs
rxs: cvl
jfp: fls tlz lmg
xzn: klz rtz zvb
vtr: brn pgh dnx tmq hfz fcl
bxf: qfz
tlb: plx qcf
hhq: jgq
hbc: csm kmj xtl
qrr: fhr vxf fms
mxq: ngt bnm
rfq: lbg ttt pds lsg gnh
cqn: xkt hkb msm zzd dzc
skt: mrd sqs hfz svv bbj rtc
ftz: npz lcf ctf
qkj: qkx
hsm: hfp tpb qsf xhb vrn vnc
lxs: kpj
sgb: skr vzq
pqf: qcs
pfl: lxs ktj lsp knh
njv: mnj qkx
zkh: ghk nmg
jcm: lvd
kgg: qgc mdp dpv
snz: vrd jkm pbx zjl
drs: tbr
tnr: hlp phn
kfk: dlx
dgb: dzq dtv
ndd: vqd
rbc: ntm tmx
tcd: vvb
nnd: gmx npc fgq mtm
grt: vcg jgv sgb
chl: hlf jgs
dhp: zmj mrr cpt
dxg: vph vvh srj djp
lsb: zcg rzf
mfv: hrz hfd kmd
xcs: qtp hhd bjp mzj
vzr: flz
zkl: rtc tlx
fsh: prn mmz
qtr: mdn dkt lsp
nqm: rmj qbc qbm
pjk: rgv
mdp: kqf
trt: hhq gqg
ddh: fnv gkj
jxh: tbr
qdg: bfb
ldj: fcd
mtz: cpx sbf
psp: zzr
xzv: vnl ndd xsc tch
tkc: pnp vht qlh
zgp: lpt qcp nmn ktj
mdk: qcp
fqn: bdc
jtx: fqt
xmm: tgj lpz
ghk: jsc szl
dvt: lvd
hnj: vnc vnh fxf zfh
kzm: lst bjd fhc skf jdv
rzf: tks
nqc: dxx hzl qjx kpj
hrs: gpf lrq bjp
crq: gtx tjk
fmx: lss lvj ttc qtg vrg
xvc: ntf bzd fcd pps
xfp: xsm bjp lkm
fnc: fqf qhb kmm jdv
vcf: pxj mcn mqq lch
pnn: vvb fds xbh bkc fhc jbl knh
nvm: qlh tpf hrl
sct: mqd mcj
dff: pkr rgq dtv
tvs: npm bbd
xxg: hhj njk plx nmg
zgm: pdc
ghf: gqc rxt dtl
tdq: ldn ftv flb
lsj: gtk ngj bdg
vxb: cvl qgq fkm
rnd: lrq
mhq: tlv snd
ccf: mvt
bxr: phn tqp jqq hrv
bnn: bdg prf vrg dtz
mqv: ljx fcz vkl
znl: dsj str rsb ldn
pdc: tjk
fbr: dvt lzk
tmv: hkq
xkt: zhq fdq
rfs: xxk tlx tzt sfq
knk: ndh xdn fdx
nhp: nzv vcg gvx
jfz: dlc fjs
lgq: ssl xfs jqm
cnt: lzk
fmh: xjz vbr
zgr: mtj ccf qmq
fhc: jgq
krb: gkn zhb rmc
rzm: xdq
jqf: zgf nfb fqp kfc jkn
gnj: gcp blf qck
bpl: htd nhz dzs dvb
vnc: rfp fkz
ptn: mfs fbh qsl cbv tjr
gvp: jtx hzc vzr
gbs: mzj msl dnb bxr
fdr: gbb
htd: qgc
llr: mfb nql
ggk: pcd fdx
gkn: fkm
dzs: lvd
kfc: fkt
xjn: zph zvq lhc rsp
hvr: mrr zch blf
scs: xfp tgg zzr tbr
dhb: dpj qkx lcj
qtc: tbd jfl msr dbd
fvl: jjs dlq
rvk: sng mdp
dcm: fbr lxn pqp zxl
qqh: rvx pmm ptb
fqt: xsn
gnb: gvx nzs
fqg: dlr tld nrv
rfz: lnl vxv
cxg: nzv czm
svj: cnm xjb
mqq: jrg
bbb: tgh lvd
vxf: pqf mrg
kct: gkm xrr cnt sxz
hng: dfn pgt clp lks
qrd: mkx
gmg: szl xdd
pdv: fqx nqm vbb ndh
njk: ksc
tbj: dpj gjr rqh qcg
csm: mpl
lss: ssl
vxt: ztk cfp
bkz: szg
pqz: hqj mdh
vhn: lpt cbr
kvh: ccf jsx zfh plt vfb
fzd: pvb jxg rzf fvm
gcq: kjd rrr ttt
mqn: jgg
xsx: tld lth rlb rkk
dpj: htq
mmm: qkf cnt rhh cgz
pgr: vxf rlb
xcr: mdh sbf
bdn: vqd kms zgt dlv
zdb: nbp fqh
krj: zgm rrr hgt
mtt: rgf sxx lgn
xks: bst hld mxq sml
rcd: rkk zcs tjk gbh
mtj: jpt
zdx: vzr
xdz: zgk
npb: skr
pcd: fdg
zsj: rtx kms
vjl: tjn mqv xfb jqc cbp
nhr: dcl tdk xlh
xfn: nhr xkj dgd
kzd: tfx hfz
dvb: dhb tfr jtx mzr
hjb: cvv gkj nrv
kks: vvq ffj scc mfk
cmh: hzl rjg
fhr: lpt
vjk: ptb pvr ddz xrm
njn: gnj lgq qcl kmd tjn gcp
mfc: bld cmh cnh qcs
vpp: dqk fls ctl rgq
xrr: fdr gfk
tgm: tsx cbv xtl
jvx: zkl
vrh: tch
tdk: hcc prn fbr
mpd: xkn
qqt: jgf
ndk: hrz pxz jgf svz
jdd: nct xtl lvf fcr
lkb: lfc qkj mkk grp csm
jxd: gqq sbc
mkt: nxr xrm csb fhr ppn zdc
fqh: sxl knv nbp
fdg: vbb
jqc: xhn jcm
nkv: pfq zhq szg ngd
mtf: tcv
pnh: mcj nkq rxr
zzr: vck
pxv: prf dtl zsq
zbn: zsq jlk
bdl: dpb hbs lxn grt
kbc: dlx nvf mnn
xsp: jrz nfq bxv zbx xsk
hcc: xdh rpb
mss: ntz xzs hxb
mqd: nrl
hkq: kmc
rfg: cnm hnr
sbs: vjz ktd hzv fvd
brh: tgv ngd hld lkc
bhb: xhb tvj
mqc: zdq npv
pps: djp sml fnv kmc
fvm: ghk srp hgk
cxz: lmp
krp: sgj zxr
nfr: stc cvr mvz vck
qbm: bxf bqk
dfn: cdd
crk: str plt pph
sdf: krp jvs hkf fzx
hqj: kxt
ddc: psl dbb
lkp: sbc jrz nfl rfl
svg: mjt nrv lzq gtz lbp qqh
tgt: gtk htq nzv fzh
npm: rmc kdl
clt: hzl mnn
hst: drx
zcf: rtq jgf lch
hjf: zpd xbh fdq
bjt: mcn ztk jqz tsp kbp
ztq: jgv plm znp
zzx: dhg zpd tnr
mxv: pjk ktj mgr vzf
kmx: vxg dbd qrh dfn
dxx: dcs fqn
tpf: rbp xdq kqf
gqp: rgv
xkl: dlq fzc ncf
qkg: djp ttt lbg
rgh: ptb xmn hlq
xbx: frb
vpr: qcs bhb lhc ldj
bnf: zbc
rlb: krp
zph: lqv
kcq: cns lpb hhg ctd njv
gpf: xrm tjk
rvb: zbp vqp ztk nvq
zxj: jsm mcn lkl xvj
kbp: dtl jvn hts
fzb: cxd bhl lcf lgk
kkm: ndk htp fsx cls
qxz: kmc djp
fcg: rmm zdc
blj: knh dfv tbr rmj
msh: fsh tgm
qcd: bqv
qkv: szz
gjr: qkv tlv
pph: jgp dlx lzq
cxd: tln lzc
xmn: hmm bbq
tjs: rmm
tvg: gcp qmp lvp
xrv: rld zbs dxv
lvt: pds tjs lkc mtz
dpp: pqf hrv bhg tdq ndh
nmj: zxl zsj tfx cns xdh jzj rfz
vnl: kdl
bzq: qbr prp
njg: ksc kvh sqp llj
fhl: ngd srp jgg
mng: ndk xjb mmf cfp mgc
cgz: jcm jlj tmx hgl
ttb: cjz skv
qjq: qfz hsl mfb
dtb: fxz qms frj
lvj: dhj jnc lfc
qdh: qcp
tsd: drx vss bqs tvl
hmd: lpt lst psp mzk
stb: dhb nzx qrh
flb: nmg rnd
kqd: pbj
njq: vtr zjl jzf
qgq: sfq
dms: kjd czh tpn hhq
lhp: rgv
sjm: rnd
prk: grp rxz jkm jtx gqf
tcr: zcg xjt hkf
zcs: czh ppv
hmf: rfp hhn
kbv: mpl dkn
zzd: crn ddf
rvn: ddh flb fdq
pnp: vzq txl
khn: flz bxb vrg
sng: drx qrd zzt
rcv: sdf pcd trt dzd
pkc: qlh sff lfc nvq
jfq: ffj kvb psp vrn
clf: tct
klk: ttc mqg xgz lcj
mnr: ftj bnm jvs gds
tfk: hph prp hkq zgr
klz: bch
gds: mgr fhr mfk
rgq: nmp nmh
jxt: ttb
lxn: npc
gms: tsk mvt sqp ntf zgm
zjv: drs
hhj: nbp ftv tcs
clm: vqn kmd xlh vfv kjh
hgk: clf kfk dhz
cbq: kdc xkt hgt zgm lvv
mzj: jbr qbm
cdp: zdq
pgt: tgh cns bdp
frj: gbb vkl
qcm: stp kmm chl dzd dbb
dlr: ktr hkq
bdp: jsm
zpd: ktt mgr
qtf: xlz jls jqz gvv rpk
tsm: kbs mdp
lcb: lxb rmd
nrz: rmd gtx hzl
vqx: mmf
rhb: rbp
nrd: bqv
rpn: brx
qkl: xbl tzt gdq hbv
rzz: gqp hqn dnq
dnb: vbb
hhm: dlq plx
gpp: svj htd dff xbc
gxq: xbj grg bhb thz npv
jrx: svv mmb vxv nmh
dpb: xvm kbr
zbx: dzl bph nxr dlc dlh
gbz: gdq qhr xjb klz mcn xvm
jlj: jvn gtk
nhv: ccg mcb brd
qhx: qqv jbg
hbv: dpv jth
chf: hnr dpj fxr
xjb: rxr
xrx: vhr lhp vgm
hlp: mjb msm
nkk: scc ngd
gfq: tmv gmg xfj
pxj: jgf
vlk: ktl hhn
vhh: ddz
hsl: hmm tnr fnl sjm
zff: jvn lkl
tfr: vzr skr gfk
vzf: qgm fbm
sqp: tmv
sml: tct
tbd: bch mkk vnl
tkl: vvt kst bcr lgn
bjn: hsl fzj ftk
vnq: zpp zdh zmj ddg
vgx: xzs zzt vrh cvk ngv
tch: sff
hxj: zml
zmn: ttj rjg nrz njb
jhq: sjm
tjk: vmg
jlk: dnk
klc: nql qhx jpk
jvs: fnl fcf
nkt: bbg
kbk: kxt jdv hfj
grr: mgc btl qrh
ppr: dgb jgv
nfb: mfb
lcj: lnl
dgs: jdn ddc jpv tjt
hld: kfc vbb
hlv: gfn
jrg: jlk
mgc: blf
gtj: qms sdr ggm mzr lcv
spq: dlv dpb ctn
nhz: vxt ngj lpb
bbj: hrl lfs dzq
fcl: tsx
lst: nlk mkt
dlh: tcd
nvl: jhq knk lpt
bkd: rvg xrm zdb
mll: jkn fkz
rsl: pnp bxc pqp rsx bnf
kpj: lhp
xfs: bqs kst
bxv: pvr pqz hhm
skf: mrj hmm
xct: jxh hfj bdm ndh dbb
gnv: bcz gsv
vsq: sqs vnl
blf: nkq
vfb: fkp mcb tks msm
rmj: cnh
rgt: dpp gqk
hnh: pvb pdd txt xcs
tlx: tvl
tjf: fms hft
ghc: stp kvp vhx zgm
nzx: crc kmj tnf hnd
rfl: mtf pmm
jkg: nvl clb dxx
tnf: hst vnl
kvb: xjt hqj
pfq: lhp jmj
rmp: zdq jbr bkz vck mdk
zml: qcf plx ffm qcs
xtv: pbj jxg
vpv: jxd tjs bxf bnt
hgr: vjj rvb gjr tfx
lfg: rhd rzb fzh jjg zbn vrh
rhh: vzd ffb txl
lps: rpk hgl rbc rbs
fzh: msr pzr
xrp: lcv frb prn pzr
xnx: tjf rqt xbs
bsh: xtv mdn bxh
bpj: tpf lmg fxr ctn
jzj: jdb lnl
rkp: tcs nkt jdv
ttt: rmj
lmf: jdv rsp ffj tsn
ktx: mqg qkj
zmp: tvh hbl mcq jth
zzb: ljx dhc kjh
lvv: fbm dhz hxz rxb
crr: vks ztn mkm ndb kgg
mcn: mtm fcs
crn: mpd
nnc: zff tlz lkl
mzf: xbs jgp fdg
txt: cdc
vmk: dzs lzc
gbh: bbp vvh
fzc: tvj
lvz: fkt xkn pds zzr
mzk: xcr jxh tnr msl
jxz: vtj
xmj: cqp pfq pmm
vql: hzk rjg cqt lpt
phn: vbr bhg
hxb: mpq
prq: hqn xfm rzz dmv
gqg: dnb tsk
hpt: nvz lkc ggk bnc qbc tpb
fgh: hkf clf bbg
ztk: lpz
mdt: cbr
hvc: lqv rkk gfq hlp
hsr: ccf
zfh: krs rcn qbv nkt
lnn: lxb lkm xdz
mbx: ffb kcv
qzx: mzh srk
vpk: nsq gqk rgg rfp
jpt: pcd
lth: cdp zph
cbc: mvl vvq tcv
xzt: gvv tvh jcc
xbj: jbg pjk
xxd: lnk dtz gkn kjh
dgd: dgb mgc pzr
xfj: qbv grg
mlc: dpv
ffj: ncf cxz
hjp: pmx lth dfv
rnk: gfk sfd klz fbr
vcv: lnk rhh xdq mzt
rqh: dtk jxt
ddf: dcs
rvg: vxx qxz fzj
bhg: dlx
fcr: zhb prf
dcj: gcc fvl bxr
vxg: mmr gfk cfd
mhm: knv bbp
ncc: pgt vsq snv zhb
svz: dkn mmb
qhb: clf tbk slb
lqv: zdq
nmv: dvt bch skg
crc: xln dnx fdc
qcg: gvx zzt
lqb: hrz xff bnn
tgv: mzc
xsm: vhn
vvq: mfb fcg
mtm: tlv
fbh: pzc dcl rgf vbg
knv: qcf
sjl: crc rcb vqp qgq xnr sxx
fxr: zdx
gmx: mqq ttc
ddz: tcd
nch: drx mfs qrz
sfd: rtz mdp ttq
vpx: xlg tct vmg gsr
tmr: vnc msm lvz
gcc: lhp xdz
hhd: txt
qkc: rld sll hjg
hqf: mjb mhm
jgp: tbr
rgf: lpz
xkj: fcr cbv jzz ftz
tlz: lkl
ffb: skr
fms: slb tbc
xsn: qdj
jkm: nrd
nfq: hlq nkk
xxc: rsc vzq xsn tgh
jsx: dfv bbp nfq
rhl: jzz fcl gqb
fvj: xjz
fkp: mfb
lnt: mdn bsh xsx bxv
lzb: mrd cjz
mxp: slx txt vhn ddf
fcf: khd mvz msl
vfv: grr hxb
pcl: dnk mmf rqh mkx
snv: dnk gtf tsd
klt: clt qjx sbf jxg dzd
qhh: znl qdh ddf nxz
sdg: fjs fvj bkc
fcz: zbc dcl
dkn: fdc zfb
njb: hzl clf
drd: pxj gqc nfd pnh
xxl: cbl tmv tqp rgt
gqf: djf cxg nzg
jsr: njq kdl lll jvx
hfn: vzk tbc gsz cnf
zcz: lnl
ctl: vxv zhb
jrz: gkj vxx
hmv: ggm gtf sqs rtm lcj
zbg: vzd mcj ctl
vmq: qgq
nst: nzg tkn sxx rzd
mnx: qrz ctd pcl lvf qrp
qgm: ndh
stc: kmz fzj
rkk: bxr
lpb: rhd
kvk: bqs stb lsj prb hts vxg mpl
tbq: sjm cdp
plx: cdc
qtp: dlq
xsc: qrz gqb nmp
ppf: rmp ngm zcg bpn
nfl: ffm qdh jpk
rjc: xkb nhp jrx lqm
bcz: vxv kbv
jbr: fvj sdg
zgt: pkc ljj
pvn: kpj qnz tzc
xvg: fvl dnq
snk: kbs bnf lnr jtx
lsg: nkt
kzq: hjg
fjs: txt mdk
tjr: qsl sjl rmb
kkj: bxb jgv hzc
xrm: lxh
mvl: hft qbm
dbv: tlv zmp
qbr: vmg dmj
bgz: hqv hph bjn zpd
ttc: cfd hlv rhb
vvt: hgl
flz: mzh
pth: dmj
zpp: nzg mmb
hkl: fnv pgr tmv nqm jbg
xhl: sct ftn npm lqm
hqn: pds jsc cfk
czh: rsp rxb
jzk: lhp crn lfh
kdc: mzc lnn
kvp: ftk xnz xct
jbv: dlh dnq
bgb: klc tbk zdb
ngm: nlc lpm mrj jjj
nqh: rgh mdh dcj dmj
hvv: zvb
gnh: kmz qmk cfk
sll: bnc hqj rld
mjl: vss ppr kbq vqn
mkm: pxj mqq
pqp: scm rgc vmq djf
ggc: lsg tks slb
qcq: crg mcr ztq gmx
kjh: sff
lqp: gfn qrd
qzg: qlh ntm lzb lzp pzr tsm nch
tvj: kfj bdm
kts: ctf hxr jdm vtj
tcs: kqd fvj drs
nzg: qgc
tlq: mnj lmg vrd ttc rfg nzs
tjn: hrl
bfq: cjz qkv
qpg: lxh xdn
mzr: vzq
rmt: kbf spq bgh ntz fjc
zbs: ldj zfh bfb
kcm: cqp flx vxx rmj kvb
rmx: cbc chl tcr phk
zkj: ffb pqg zxj qht
fcx: fxz gcp mrd
gsv: dcq xnr zff
fhp: hbv pzc rng
dbb: bdm
txl: njv qkx
zsh: lpt dlh jcz jgq
jdm: qms gbb
kbr: lcr lvj xpn xlz vqx
cjz: gtf
xsv: tcd hbd bbp ldj
ttq: rzd prb ztk
fqs: fsz vcg jqz
sxz: pvg fsz
rjg: xhd
fvd: kgm kzq xfm
ngv: rvk
dmv: ngt xdd gtx
tks: xkn
zmc: xhd djp bfb
ccg: hlq tjt
rng: bdp dnx
llh: ddc fkp zcs
kms: lsj jrg
fxf: ttj bhg txt tjf zhq xkl
qbc: qhx zzr
nnb: fds tbq lsb mxq ddz
jfl: fft gzj vqx fsh
skp: xbh mjt qls
fft: zxl sxx
nxr: szg ksc
tkn: mfs fft
xjz: qfz
xnh: lxs vxf ffj crq fhl
njf: lss tvh ddg mzr
mdx: knv sml
lcv: jrg
dhs: vfv jkm lxn
fkm: cfp
tpq: ppv qrr csb sbs hzk
ktt: tjt
btl: npm qkx rtq
kdf: lxb qjx sgj thz gbs zjz hxc
txk: vdl fzx mjb cpx
qsg: qcf bxh
szg: pth
gxd: sgb jqm kst
qhr: qtg
mkk: zkl qrd
jbl: fzc rkx nql
mbz: ttb qdj svz
nqt: ctx dff jnc
cpc: zbd hfz vrd npc tsp
vjv: fqs fkm grr gqb
nmp: prn
lpz: pqg
zdc: vmg
pvr: qqv jsc
nrm: htp mcq zsj gnb
lfh: hjg lmp
cvm: mkx vtj
xbc: vzd rpn ttb
xhh: ktx kfr rxr lnk
xbl: bxb cpt tch
nvz: lxh
tmq: nvq
djk: fxr lqp rxt ndd mbx
dtk: dtl zxl
zhv: jzk zbx hmm
cfp: htq
czm: jxz nsx
cdb: fqt mmf
cmr: kfj pvb lkm
ftj: tgv hsr
hts: qrq zcx
ctd: qrh stj
vjj: jqc ztk zbg
mhn: cvm xzn kkj jqc
bcv: jgf rgf vtj pkr
mvz: slb
dhk: skg kzd djk tjn
lgk: vch ghf vgx vmk
xbs: rnd bsp
rjr: lvp qdj gnv czm vht svj
dfv: dmj fqx
xjc: mvb ddg rhb rtz xtl
zdh: zzt
ntf: srp cdp
dgf: mqn lsb hmf
qdb: mdk hlq cdc jmj
xdh: mzh
xvj: lvd qgc
djh: zzx nvz jqn fqp
vdl: dgf tqp mqc
tzc: zxr
jcc: sng mtx lzk ntz
xpj: nzx nmp lzb dfn
hrz: rpb
dlg: vrh vzg gbb jcm
mdn: hhq xnz
vvh: mpd
zfb: gfn
lpm: tjf thz dxt
crg: ddg xhn lcr
fkj: msh rpn czn xrr
zbc: xdq
vch: gsv nnc vsq
bzd: gmg zjv bsp
dbn: qmk nlf qqh rvx
clp: frb mmb dhj
dhc: stj qcd
pbv: kzj krb qgc qrp
kph: sfq
sqh: dtz xbx rcb vgj
lsm: tqq ktx fvz lpb
sff: dcl
tss: mtj psl ncf cnh qcp
jbg: mtq
hfp: brr bld jkg
bgk: dth pcf mpq
khr: mhb tzn pjt
jsb: bqs bbd tzn pgh
cbp: szz cvm qck
gxk: hhj slx bxv kfk
rrq: nrd gqb tsm znp sxz fdr mqv
mvt: rkx
lgn: skg
rzb: prk snz nsx
qtg: hfd lgn
xvk: llr tlb dcs jfz crq
mrg: tss zcg mdt
nsx: skv
fnl: lsp nmn
qmp: xfs msr fcl
xlh: lpb
grn: rxr fxz tst krd tfx
tkd: qbr xbh llh jgg
vbr: mgr
dhg: vhh pqf rbq
szz: pzr hfd
cnf: zjv
qnz: sdg mvl kfc
pkt: rzm cxg xmm tvg
flx: ccg psl bnv
lvp: rtc
mjn: grc qkg khd clt
ckd: jdm czn
vvn: ljx qrq kkj
bqk: jxh
mhz: ftn rtx skv rfm hbc qrz
tsc: xsk vbb ktt
ncp: tgj
mvd: vzf mcf fms gbh
nxz: nvf ktl
xpr: msr tqq stj
gkg: njt mdp zdx cls
zjz: gtz qsg qdh
mmz: lkn mqd
jgs: vkb fcd
vkn: lzc ljj tsp ntm
jls: tpp qht vxt
bbq: kjd lsp nmn
tpb: xgz qbv dvf
vjz: dmj
zsq: dzq
jmc: qkx zjl lss jcx
brd: xkl smb
xxk: lch nrl rxs
trp: vks lzc xfs csm
bkb: fvl qgm tjt bdm rlb
vcg: fls
qnj: sng jth lss tjr cns vkl
xcb: kqv cgz kkj vqp
tsf: bbp qbm gpf njk
mbh: pdc hkh ttt rfl
fdx: dlx
kqf: rbp
kzj: gfn cnm
lpl: mkm dbv cmb qrp fsh
fsn: dgs kzq rvn cnf dvf
mzt: tsx kcv fcs fcx jsm
cbv: mvb
hbl: hvv rbp
jvc: mqd rgq fhp
bvt: trm rsx hlv fjc
hpv: xmj lxs zkh szg hxz